#####B#
##### #
####  #
#### ##
    A##
#######
